0 0 0 0 0 0 0 0 0 0 0 0 0 0 0 0 0 0 0 0 0 0 0 0 0 
0 0 0 0 0 0 0 0 0 0 0 0 0 0 0 0 0 0 0 0 0 0 0 0 0 
0 0 0 0 8 8 8 0 0 7 0 0 8 8 8 0 0 0 8 0 0 0 0 0 0 
0 0 0 8 0 0 0 8 0 0 0 8 0 0 0 8 0 0 8 0 0 0 7 0 8  
0 0 0 8 0 0 0 0 0 0 8 8 0 0 0 8 0 0 8 0 7 0 7 8 0 
0 0 8 0 0 7 0 0 0 0 8 0 0 0 0 0 0 0 8 0 0 0 8 0 0 
0 0 8 0 0 0 0 7 7 0 8 0 0 0 0 0 0 0 8 0 0 8 0 0 0 
0 0 8 0 0 0 0 0 0 0 8 8 0 0 0 0 0 0 8 0 8 0 0 0 0 
0 0 8 0 0 7 7 0 0 0 0 8 8 8 0 0 0 0 8 8 0 0 0 0 0 
0 0 8 0 0 0 0 0 0 0 0 0 8 8 8 0 0 0 8 8 0 0 7 0 0 
0 0 8 0 8 8 8 8 8 0 0 0 0 7 8 8 0 0 8 0 8 0 7 7 0 
0 0 8 0 0 0 8 0 0 0 0 0 7 7 1 8 0 0 8 0 0 8 0 7 0 
0 0 8 0 0 0 8 0 0 0 7 7 7 1 1 8 0 0 8 0 0 0 8 0 0 
0 0 0 8 0 0 8 0 0 0 8 1 1 1 8 8 0 0 8 0 0 0 0 8 0 
0 0 0 8 0 0 8 0 7 0 8 7 1 1 8 0 0 0 8 0 0 0 7 7 8 
0 0 0 0 8 8 0 0 0 0 0 8 8 8 0 0 0 0 8 0 7 7 7 1 1  
0 0 0 0 0 0 0 0 0 0 0 0 0 0 0 0 0 7 7 7 7 1 1 1 1 
0 7 0 0 0 0 7 0 0 0 0 0 0 0 0 0 0 7 1 1 1 1 1 1 1 