0 0 0 0 0 0 0 7 7 1 1 1 1 7 7 0 9 13 13 13 13 13 13 13 9
0 0 0 0 0 0 0 7 7 1 1 1 1 7 7 0 9 6 14 14 14 14 14 14 9
0 0 0 0 0 0 0 7 4 4 4 4 4 4 7 0 9 14 14 14 6 14 6 14 9
0 0 0 0 0 0 0 7 5 5 5 5 5 5 7 0 14 14 14 14 14 14 14 14 9
0 0 0 0 0 0 0 7 5 5 5 5 5 5 7 0 14 14 14 14 14 14 14 14 9
0 0 0 0 0 0 0 7 2 2 2 2 2 2 7 0 9 14 14 14 14 14 6 14 9
0 0 0 0 0 0 0 7 7 3 3 3 3 7 7 0 9 14 14 6 14 14 14 14 14
0 0 0 0 0 0 0 7 7 1 1 1 1 7 7 0 9 14 14 14 14 14 14 6 14
0 0 0 0 0 0 0 7 7 1 1 1 1 7 7 0 9 14 14 14 14 14 14 14 14
0 0 0 0 0 0 0 7 7 1 1 1 1 7 7 0 9 6 14 14 14 6 14 14 14
0 0 0 0 0 0 0 7 7 1 1 1 1 7 7 0 9 14 14 6 14 14 14 14 14
0 0 0 0 0 0 0 7 4 4 4 4 4 4 7 0 9 14 14 14 6 14 14 14 9
0 0 0 0 0 0 0 7 5 5 5 5 5 5 7 0 14 14 14 14 14 14 14 14 9
0 0 0 0 0 0 0 7 5 5 5 5 5 5 7 0 14 14 14 6 14 14 14 14 9
0 0 0 0 0 0 0 7 2 2 2 2 2 2 7 0 9 14 14 14 14 14 14 14 9
0 0 0 0 0 0 0 7 7 3 3 3 3 7 7 0 9 14 6 14 14 14 6 14 9
0 0 0 0 0 0 0 7 7 1 1 1 1 7 7 0 9 14 14 14 14 14 14 14 9
0 0 0 0 0 0 0 7 7 1 1 1 1 7 7 0 9 11 10 12 11 12 10 11 9